ShortCuts_Control_TIPS	ShortCuts will be used for ToPanel Button
DisableZone	DisableZone for CSUR Shift Ramp and Transition Road
UpdateZone	UpdateZone when load game
Lane_Smooth_Level	Lane Smooth Level(for debug)
LaneType	Single/Dual/Uturn/Asym+1/Asym+2
RoadType	NA/SideWalk/SideWalk&Bicycle
StayInLane	StayInLane for selected CSUR node(Need TMPE)
StayInLaneAll	StayInLane for all CSUR node which is necessary(Need TMPE)
Copy	Copy
Swap	Swap
Clear	Clear
Low	Low
Medium	Medium
High	High
Experimental_Function	Experimental Function
Function_Button_ShortCut	Function Button ShortCut
ShortCuts_Control	ShortCuts Control
Lane_Button_ShortCut	Lane Button ShortCut
Lane_ShortCut	Lane ShortCut
From	From
To	To
Function_ShortCut	Function ShortCut
Debug_Mode	Debug Mode
EnablePillar	Enable Pillar
AlignZone	Align Zone For CSUR Road
FixLargeJunction	Fix Large Junction
NOJunction	Remove traffic light for complex CSUR node, fix pedestrian cross issue(need reload)